{
  "stage1":{
    "tName":["tile01.png","tile01_a.png"],
    "layer1":[
        [42,41,41,41,40,40,40,41,41,42,41,41,41,40,40,40,40,40,40,41,41,41,40,40,40,40,40,40,41,41,41,42,42,41,41,40,41,41,42,42,46,46,46,46,46,42,41,41,41,42,46,46,46,42,42,41,41,40,40,40,40,41,41,41,41,40,40,41,41,41,42,42,41,41,40,40,41,41,41,42,42,41,41,41,41,40,40,40,40,41,41,42,41,41,42,42,42,46,46,46,46,42,42,41,41,40,40,40,40,40,40,40,41,41,41,41,40,40,41,41 ],
        [46,46,42,41,41,41,41,41,42,46,42,41,41,41,41,41,40,40,41,41,42,42,41,40,40,41,41,41,41,41,42,46,46,46,46,46,42,42,42,49,0,0,0,0,0,48,42,42,46,49,0,0,0,48,46,42,42,41,40,40,41,41,41,42,42,41,41,41,42,42,46,46,42,42,41,41,41,42,42,46,46,46,46,42,42,41,41,40,41,41,42,42,41,42,42,46,49,0,0,0,0,48,42,42,41,41,41,41,40,40,40,41,41,42,42,42,41,41,41,42 ],
        [0,0,48,46,42,42,42,46,49,0,48,42,42,42,42,41,41,41,41,42,42,42,42,41,41,41,42,46,42,42,49,0,0,0,0,0,48,46,49,0,0,1,1,1,0,0,48,49,0,0,0,0,0,0,0,48,46,42,41,41,41,42,42,46,46,42,41,42,42,49,0,60,48,42,42,42,42,46,49,0,0,0,0,48,46,42,42,41,41,42,42,46,42,42,49,0,0,0,0,0,0,0,48,46,42,42,42,41,41,41,41,41,42,42,46,42,42,42,42,42 ],
        [0,0,0,0,48,46,49,0,0,0,0,48,46,42,42,42,41,41,42,42,46,46,46,42,41,42,49,0,48,49,0,0,0,0,0,0,0,0,0,0,50,31,31,31,0,0,0,0,0,0,1,0,0,0,0,0,0,48,46,42,42,42,49,0,0,48,46,46,49,0,0,60,0,48,46,46,49,0,0,0,0,0,0,0,0,48,42,42,42,42,49,0,48,49,0,0,0,0,0,0,0,0,0,0,48,46,46,42,42,42,42,42,46,49,0,48,46,46,46,49 ],
        [0,0,0,0,0,0,0,0,0,0,0,0,0,48,46,42,42,42,42,45,0,0,0,48,46,49,0,0,0,0,0,0,0,0,0,0,0,0,55,1,31,30,30,30,1,1,1,1,0,0,31,1,1,0,0,0,0,0,0,48,46,49,0,0,0,0,0,0,60,0,0,60,0,0,60,0,0,0,0,0,0,0,0,0,0,0,48,46,46,49,0,0,0,0,0,0,0,0,0,0,0,0,0,0,0,0,0,48,46,46,46,49,0,0,0,0,0,0,0,0 ],
        [0,0,0,0,0,0,0,0,0,0,0,0,0,0,0,48,46,46,46,49,0,0,0,0,0,60,0,0,0,0,0,0,0,0,1,4,1,1,31,31,30,30,30,30,31,31,31,31,0,0,30,31,31,51,51,0,0,0,0,0,0,0,0,0,0,0,0,0,60,0,0,60,0,0,60,0,0,0,0,0,0,0,0,0,0,0,0,0,0,0,0,0,0,0,0,0,0,0,0,0,0,0,0,0,0,0,0,0,60,0,0,0,0,0,0,0,0,0,65,66 ],
        [0,0,0,0,0,0,0,0,0,0,0,0,0,0,0,0,0,60,0,0,0,0,0,0,0,60,0,0,0,0,65,66,0,0,31,31,31,31,30,30,30,30,30,30,30,30,30,30,67,0,0,30,30,31,31,0,0,0,0,0,0,0,0,0,0,0,0,0,60,0,0,60,0,0,60,0,0,0,0,0,0,0,0,0,0,0,0,0,0,0,0,0,0,0,0,0,0,0,0,0,0,0,0,0,0,0,0,0,60,0,0,0,0,0,0,0,0,0,0,0 ],
        [0,0,0,0,0,0,0,0,0,0,0,0,0,0,0,0,0,60,0,0,0,0,0,0,0,60,0,0,0,0,0,0,0,0,0,0,0,0,0,0,0,0,0,0,0,0,0,0,0,0,0,0,0,30,30,0,0,0,0,0,0,0,0,0,0,0,0,0,60,0,0,60,0,0,60,0,0,0,0,0,0,0,0,0,0,0,0,0,0,0,0,0,0,0,0,0,0,0,0,0,0,0,0,0,0,0,0,0,61,0,0,0,0,0,63,2,50,3,1,1 ],
        [0,0,0,0,0,0,0,0,0,0,0,0,0,0,0,0,0,60,0,0,0,0,0,0,0,60,0,50,1,2,50,0,0,0,0,0,0,0,0,0,0,0,0,0,0,0,0,0,0,67,0,0,0,0,0,0,0,0,0,0,0,0,0,0,0,0,0,0,60,0,0,60,0,0,60,0,0,0,0,4,1,1,0,0,0,0,0,0,0,0,0,0,0,0,0,0,1,55,51,51,0,0,0,0,0,0,0,0,0,0,0,0,0,0,62,31,32,32,32,31 ],
        [0,0,0,0,0,0,0,0,0,0,0,0,0,0,0,0,0,60,0,0,0,0,0,0,0,60,0,31,31,32,31,0,0,0,0,0,0,0,0,0,0,0,0,0,0,0,0,0,0,0,0,0,0,0,0,0,0,1,1,2,4,51,50,1,4,1,0,0,60,0,0,60,0,0,60,0,1,55,51,32,31,31,70,70,70,70,70,70,70,70,70,70,70,70,71,72,31,31,32,32,0,0,0,0,0,0,0,0,0,0,0,0,0,0,62,30,30,30,30,30 ],
        [0,0,0,0,0,0,0,1,1,3,0,0,0,0,0,0,0,61,0,1,4,51,55,0,0,61,0,30,30,30,30,3,2,55,23,23,23,23,25,25,25,25,25,25,67,26,27,0,67,0,0,0,0,0,0,0,0,31,31,32,32,32,32,31,31,31,0,0,61,0,0,60,0,0,60,0,31,31,32,30,30,30,71,72,71,72,70,70,70,70,70,70,71,72,32,32,30,30,30,30,0,0,0,0,0,1,1,1,1,1,0,0,0,0,62,30,30,30,30,30 ],
        [0,0,0,0,0,0,0,31,31,31,0,0,0,0,0,0,0,0,0,31,31,31,31,0,0,0,0,30,30,30,30,32,32,31,31,31,31,31,30,30,30,30,30,30,25,28,29,0,0,0,25,25,25,25,23,23,23,30,30,30,30,30,30,30,30,30,0,0,0,0,0,60,0,0,61,0,30,30,30,30,30,30,32,32,32,32,71,71,71,71,71,71,32,32,30,30,30,30,30,30,67,0,0,0,0,31,31,31,31,31,0,0,0,0,62,30,30,30,30,30 ],
        [1,1,2,2,50,1,1,30,30,30,4,1,1,50,1,1,0,0,0,30,30,30,30,0,0,0,0,30,30,30,30,30,30,30,30,30,30,30,30,30,30,30,30,30,30,30,30,70,70,70,30,30,30,30,31,31,31,30,30,30,30,30,30,30,30,30,0,0,0,0,0,60,0,0,0,0,30,30,30,30,30,30,30,30,30,30,32,32,32,32,32,32,30,30,30,30,30,30,30,30,0,0,0,0,0,30,30,30,30,30,67,0,0,0,62,30,30,30,30,30 ],
        [31,31,32,32,31,31,31,31,31,31,31,31,31,31,31,31,0,0,0,30,30,30,30,0,0,0,0,30,30,30,30,30,30,30,30,30,30,30,30,30,30,30,30,30,30,30,30,70,70,70,30,30,30,30,30,30,30,30,30,30,30,30,30,30,30,30,0,0,0,0,0,61,0,0,0,0,30,30,30,30,30,30,30,30,30,30,30,30,30,30,30,30,30,30,30,30,30,30,30,30,0,0,67,67,0,30,30,30,30,30,2,51,1,4,62,30,30,30,30,30 ],
        [30,30,30,30,30,30,30,30,30,30,30,30,30,30,30,30,0,0,0,30,30,30,30,0,0,0,0,30,30,30,30,30,30,30,30,30,30,30,30,30,30,30,30,30,30,30,30,70,70,70,30,30,30,30,30,30,30,30,30,30,30,30,30,30,30,30,0,0,0,0,0,0,0,0,0,0,30,30,30,30,30,30,30,30,30,30,30,30,30,30,30,30,30,30,30,30,30,30,30,30,0,0,0,0,0,30,30,30,30,30,31,31,31,31,31,30,30,30,30,30 ],
        [30,30,30,30,30,30,30,30,30,30,30,30,30,30,30,30,0,0,0,30,30,30,30,0,0,0,0,30,30,30,30,30,30,30,30,30,30,30,30,30,30,30,30,30,30,30,30,70,70,70,30,30,30,30,30,30,30,30,30,30,30,30,30,30,30,30,0,0,0,0,0,0,0,0,0,0,30,30,30,30,30,30,30,30,30,30,30,30,30,30,30,30,30,30,30,30,30,30,30,30,0,0,0,0,0,30,30,30,30,30,30,30,30,30,30,30,30,30,30,30 ],
        [30,30,30,30,30,30,30,30,30,30,30,30,30,30,30,30,0,0,0,30,30,30,30,0,0,0,0,30,30,30,30,30,30,30,30,30,30,30,30,30,30,30,30,30,30,30,30,70,70,70,30,30,30,30,30,30,30,30,30,30,30,30,30,30,30,30,0,0,67,0,0,0,0,0,0,0,30,30,30,30,30,30,30,30,30,30,30,30,30,30,30,30,30,30,30,30,30,30,30,30,0,0,0,0,0,30,30,30,30,30,30,30,30,30,30,30,30,30,30,30 ],
        [30,30,30,30,30,30,30,30,30,30,30,30,30,30,30,30,0,0,0,30,30,30,30,0,0,0,0,30,30,30,30,30,30,30,30,30,30,30,30,30,30,30,30,30,30,30,30,70,70,70,30,30,30,30,30,30,30,30,30,30,30,30,30,30,30,30,0,0,0,0,0,0,0,0,0,0,30,30,30,30,30,30,30,30,30,30,30,30,30,30,30,30,30,30,30,30,30,30,30,30,0,0,0,0,0,30,30,30,30,30,30,30,30,30,30,30,30,30,30,30 ],
        [30,30,30,30,30,30,30,30,30,30,30,30,30,30,30,30,0,0,0,30,30,30,30,0,0,0,0,30,30,30,30,30,30,30,30,30,30,30,30,30,30,30,30,30,30,30,30,70,70,70,30,30,30,30,30,30,30,30,30,30,30,30,30,30,30,30,0,0,0,0,0,0,0,0,0,0,30,30,30,30,30,30,30,30,30,30,30,30,30,30,30,30,30,30,30,30,30,30,30,30,0,0,0,0,0,30,30,30,30,30,30,30,30,30,30,30,30,30,30,30 ],
        [30,30,30,30,30,30,30,30,30,30,30,30,30,30,30,30,0,0,0,30,30,30,30,0,0,0,0,30,30,30,30,30,30,30,30,30,30,30,30,30,30,30,30,30,30,30,30,70,70,70,30,30,30,30,30,30,30,30,30,30,30,30,30,30,30,30,0,0,0,0,0,0,0,0,0,0,30,30,30,30,30,30,30,30,30,30,30,30,30,30,30,30,30,30,30,30,30,30,30,30,0,0,0,0,0,30,30,30,30,30,30,30,30,30,30,30,30,30,30,30 ]
    ],
    "layer2":[
        [0,0,0,0,0,5,6,0,0,0,0,0,0,0,5,6,0,0,0,0,0,0,0,0,32,33,33,0,0,5,6,0,0,0,0,0,0,0,0,0,0,0,0,0,12,13,0,0,0,0,0,0,0,0,0,0,0,0,0,0,5,6,0,0,0,0,0,0,0,0,0,0,0,0,0,0,0,5,6,0,0,0,0,0,0,0,0,0,0,0,0,0,0,0,0,0,12,13,0,0,0,0,0,0,0,0,0,0,0,0,0,0,0,0,0,0,0,5,6,0 ],
        [0,0,0,0,0,5,6,0,0,0,0,0,0,0,5,6,0,0,0,0,0,0,0,0,0,36,36,0,0,5,6,0,0,0,0,0,0,0,12,13,0,0,0,0,12,13,0,0,0,0,0,0,0,0,0,0,0,0,0,0,5,6,0,0,0,0,0,0,0,0,0,60,0,0,0,0,0,5,6,0,0,0,0,0,0,0,0,0,0,0,0,0,0,0,0,0,12,13,0,0,0,0,0,0,0,0,0,0,0,0,0,0,0,0,0,0,0,5,6,0 ],
        [0,0,0,0,0,5,6,0,0,0,0,0,0,0,5,6,0,0,0,0,12,13,0,0,0,0,0,0,0,5,6,0,0,0,0,0,0,0,12,13,0,0,0,0,12,13,0,0,0,0,63,0,0,0,0,60,0,0,0,0,5,6,0,12,13,0,0,0,0,0,0,0,0,0,0,0,0,5,6,0,0,0,0,0,0,0,0,0,0,0,0,0,0,0,0,0,12,13,0,0,0,0,0,0,0,0,0,0,0,0,0,0,0,0,0,0,0,5,6,0 ],
        [0,0,0,0,0,5,6,0,0,0,0,0,0,0,5,6,0,0,0,0,12,13,0,0,0,0,0,0,0,5,6,0,0,0,0,0,0,0,12,13,0,0,0,0,12,13,0,0,0,0,62,16,17,0,0,61,0,0,0,0,5,6,0,12,13,0,0,0,60,0,0,0,0,0,60,0,0,5,6,0,0,0,0,0,0,0,0,0,0,0,0,0,0,0,0,0,12,13,0,0,0,0,0,0,0,0,0,0,0,0,0,0,0,0,0,0,0,5,6,0 ],
        [0,0,0,0,0,5,6,0,0,0,0,0,0,0,5,6,0,0,0,0,12,13,0,0,0,60,0,0,0,5,6,0,0,0,0,0,0,0,12,13,0,0,20,0,12,13,10,11,0,0,0,18,19,0,0,0,0,0,0,0,5,6,0,12,13,0,0,0,0,0,0,0,0,0,0,0,0,5,6,0,0,0,0,0,0,0,0,0,0,0,0,0,0,0,0,0,12,13,0,0,0,0,0,0,0,0,0,0,60,0,0,0,0,0,0,0,0,5,6,0 ],
        [0,0,0,0,0,5,6,0,0,0,0,0,0,0,5,6,0,60,0,0,12,13,0,0,0,0,0,0,0,5,6,0,0,0,0,0,10,11,20,20,20,20,20,0,12,13,0,0,25,25,0,0,0,0,0,0,0,0,0,0,5,6,0,12,13,0,0,0,0,0,0,0,0,0,0,0,0,5,6,0,0,0,0,0,0,0,0,0,0,0,0,0,0,0,0,0,12,13,0,0,0,0,0,0,0,0,0,0,0,0,0,0,0,0,0,0,0,5,6,0 ],
        [0,0,0,0,0,5,6,0,0,0,0,0,0,0,5,6,0,0,0,0,12,13,0,0,0,0,0,0,0,5,6,0,0,0,20,20,20,20,20,20,20,20,20,0,0,0,0,0,20,20,21,0,0,0,0,0,0,0,0,0,5,6,0,12,13,0,0,0,0,0,0,0,0,0,0,0,0,5,6,0,0,0,0,0,0,0,0,0,0,0,0,0,0,0,0,0,12,13,0,0,0,0,0,0,0,0,0,0,0,0,0,0,0,0,0,0,0,5,6,0 ],
        [0,0,0,0,0,5,6,0,0,0,0,0,0,0,5,6,0,0,0,0,12,13,0,0,0,0,0,0,0,5,6,0,0,0,21,21,21,21,21,21,21,21,21,21,21,21,21,21,20,20,20,21,21,0,0,0,0,0,0,0,5,6,0,12,13,0,0,0,0,0,0,0,0,0,0,0,0,5,6,0,16,17,0,0,0,0,0,0,0,0,0,0,0,0,0,0,12,13,0,0,0,0,0,0,0,0,0,0,0,0,0,0,0,0,0,0,0,7,8,0 ],
        [0,0,0,0,0,5,6,0,0,0,0,0,0,0,5,6,0,0,0,0,12,13,0,0,0,0,0,0,0,7,8,0,0,24,20,20,20,20,20,20,20,20,20,20,20,20,20,20,20,20,20,20,20,21,24,0,0,0,0,0,5,6,0,12,13,0,0,0,0,0,0,0,0,0,0,0,0,5,6,0,18,19,0,0,0,0,0,0,0,0,0,0,0,0,0,0,14,15,0,0,0,0,0,0,0,0,0,0,0,0,0,0,0,0,0,0,0,0,0,0 ],
        [0,0,0,0,0,5,6,0,0,0,0,0,0,0,5,6,0,0,0,0,12,13,0,0,0,0,0,0,0,0,0,0,24,20,20,20,20,20,20,20,20,20,20,20,20,20,20,20,20,20,20,20,20,20,20,0,0,10,11,0,7,8,0,14,15,0,0,0,0,0,0,0,0,0,0,0,0,7,8,0,0,0,24,24,24,24,24,24,24,24,24,24,24,24,24,24,0,0,0,0,0,0,0,0,0,0,0,63,0,0,0,0,0,0,0,0,0,0,0,0 ],
        [0,0,0,0,0,5,6,10,11,0,63,0,0,0,5,6,0,0,0,0,14,15,0,0,0,0,0,0,0,0,0,10,20,20,20,20,20,20,20,20,20,20,20,20,20,20,20,20,20,20,20,20,20,20,20,24,0,0,0,0,0,0,0,0,0,0,0,0,0,0,0,0,0,0,0,0,0,0,0,0,0,0,20,20,20,20,20,20,20,20,20,20,20,20,0,0,0,0,0,0,0,0,0,0,0,0,0,62,10,11,0,0,0,0,0,0,0,0,0,0 ],
        [0,0,0,0,0,5,6,0,0,0,62,16,17,0,5,6,0,0,0,0,0,0,0,0,0,0,24,0,0,0,0,0,0,0,0,0,0,0,0,0,0,0,0,0,20,20,20,20,20,20,20,20,20,20,20,20,24,0,0,0,0,0,0,0,0,0,0,0,0,0,0,0,0,0,0,0,0,0,0,0,0,0,0,0,0,0,20,20,20,20,20,20,0,0,0,0,0,0,0,0,24,24,0,0,0,0,0,0,0,0,0,0,0,0,0,0,0,0,0,0 ],
        [0,0,0,0,0,7,8,0,0,0,62,18,19,0,7,8,0,0,24,0,0,0,0,24,24,24,20,0,0,0,0,0,0,0,0,0,0,0,0,0,0,0,0,0,0,0,0,20,20,20,0,0,0,0,0,0,0,0,0,0,0,0,0,0,0,0,0,0,0,0,0,0,0,0,0,0,0,0,0,0,0,0,0,0,0,0,0,0,0,0,0,0,0,0,0,0,0,0,0,0,20,20,24,24,24,0,0,0,0,0,0,0,0,0,0,0,0,0,0,0 ],
        [0,0,0,0,0,0,0,0,0,0,0,0,0,0,0,0,24,24,20,0,0,0,0,20,20,20,20,0,0,0,0,0,0,0,0,0,0,0,0,0,0,0,0,0,0,0,0,20,20,20,0,0,0,0,0,0,0,0,0,0,0,0,0,0,0,0,24,24,24,0,0,0,0,0,24,24,0,0,0,0,0,0,0,0,0,0,0,0,0,0,0,0,0,0,0,0,0,0,0,0,20,20,20,20,20,0,0,0,0,0,0,0,0,0,2,0,0,0,0,0 ],
        [0,0,0,0,0,0,0,0,0,0,0,0,0,0,0,0,20,20,20,0,0,0,0,20,20,20,20,0,0,0,0,0,0,0,0,0,0,0,0,0,0,0,0,0,0,0,0,20,20,20,0,0,0,0,0,0,0,0,0,0,0,0,0,0,0,0,20,20,20,24,0,0,0,24,20,20,0,0,0,0,0,0,0,0,0,0,0,0,0,0,0,0,0,0,0,0,0,0,0,0,20,20,20,20,20,0,0,0,0,0,0,0,0,0,0,0,0,0,0,0 ],
        [0,0,0,0,0,0,0,0,0,0,0,0,0,0,0,0,20,20,20,0,0,0,0,20,20,20,20,0,0,0,0,0,0,0,0,0,0,0,0,0,0,0,0,0,0,0,0,20,20,20,0,0,0,0,0,0,0,0,0,0,0,0,0,0,0,0,20,20,20,20,24,24,24,20,20,20,0,0,0,0,0,0,0,0,0,0,0,0,0,0,0,0,0,0,0,0,0,0,0,0,20,20,20,20,20,0,0,0,0,0,0,0,0,0,0,0,0,0,0,0 ],
        [0,0,0,0,0,0,0,0,0,0,0,0,0,0,0,0,20,20,20,0,0,0,0,20,20,20,20,0,0,0,0,0,0,0,0,0,0,0,0,0,0,0,0,0,0,0,0,20,20,20,0,0,0,0,0,0,0,0,0,0,0,0,0,0,0,0,20,20,20,20,20,20,20,20,20,20,0,0,0,0,0,0,0,0,0,0,0,0,0,0,0,0,0,0,0,0,0,0,0,0,20,20,20,20,20,0,0,0,0,0,0,0,0,0,0,0,0,0,0,0 ],
        [0,0,0,0,0,0,0,0,0,0,0,0,0,0,0,0,20,20,20,0,0,0,0,20,20,20,20,0,0,0,0,0,0,0,0,0,0,0,0,0,0,0,0,0,0,0,0,20,20,20,0,0,0,0,0,0,0,0,0,0,0,0,0,0,0,0,20,20,20,20,20,20,20,20,20,20,0,0,0,0,0,0,0,0,0,0,0,0,0,0,0,0,0,0,0,0,0,0,0,0,20,20,20,20,20,0,0,0,0,0,0,0,0,0,0,0,0,0,0,0 ],
        [0,0,0,0,0,0,0,0,0,0,0,0,0,0,0,0,20,20,20,0,0,0,0,20,20,20,20,0,0,0,0,0,0,0,0,0,0,0,0,0,0,0,0,0,0,0,0,20,20,20,0,0,0,0,0,0,0,0,0,0,0,0,0,0,0,0,20,20,20,20,20,20,20,20,20,20,0,0,0,0,0,0,0,0,0,0,0,0,0,0,0,0,0,0,0,0,0,0,0,0,20,20,20,20,20,0,0,0,0,0,0,0,0,0,0,0,0,0,0,0 ],
        [0,0,0,0,0,0,0,0,0,0,0,0,0,0,0,0,20,20,20,0,0,0,0,20,20,20,20,0,0,0,0,0,0,0,0,0,0,0,0,0,0,0,0,0,0,0,0,20,20,20,0,0,0,0,0,0,0,0,0,0,0,0,0,0,0,0,20,20,20,20,20,20,20,20,20,20,0,0,0,0,0,0,0,0,0,0,0,0,0,0,0,0,0,0,0,0,0,0,0,0,20,20,20,20,20,0,0,0,0,0,0,0,0,0,0,0,0,0,0,0 ]
    ],
  "layer3":[
        [0,0,0,0,0,0,0,0,0,0,0,0,0,0,0,0,0,0,0,0,0,0,0,0,0,0,0,0,0,0,0,0,0,0,0,0,0,0,0,0,0,0,0,0,0,0,0,0,0,0,0,0,0,0,0,0,0,0,0,0,0,0,0,0,0,0,0,0,0,0,0,0,0,0,0,0,0,0,0,0,0,0,0,0,0,0,0,0,0,0,0,0,0,0,0,0,0,0,0,0,0,0,0,0,0,0,0,0,0,0,0,0,0,0,0,0,0,0,0,0 ],
        [0,0,0,0,0,0,0,0,0,0,0,0,0,0,0,0,0,0,0,0,0,0,0,0,0,0,0,0,0,0,0,0,0,0,0,0,0,0,0,0,0,0,0,0,0,0,0,0,0,0,0,0,0,0,0,0,0,0,0,0,0,0,0,0,0,0,0,0,0,0,0,0,0,0,0,0,0,0,0,0,0,0,0,0,0,0,0,0,0,0,0,0,0,0,0,0,0,0,0,0,0,0,0,0,0,0,0,0,0,0,0,0,0,0,0,0,0,0,0,0 ],
        [0,0,0,0,0,0,0,0,0,0,0,0,0,0,0,0,0,0,0,0,0,0,0,0,0,0,0,0,0,0,0,0,0,0,0,0,0,0,0,0,0,0,0,0,0,0,0,0,0,0,0,0,0,0,0,0,0,0,0,0,0,0,0,0,0,0,0,0,0,0,0,0,0,0,0,0,0,0,0,0,0,0,0,0,0,0,0,0,0,0,0,0,0,0,0,0,0,0,0,0,0,0,0,0,0,0,0,0,0,0,0,0,0,0,0,0,0,0,0,0 ],
        [0,0,0,0,0,0,0,0,0,0,0,0,0,0,0,0,0,0,0,0,0,0,0,0,0,0,0,0,0,0,0,0,0,0,0,0,0,0,0,0,0,0,0,0,0,0,0,0,0,0,0,0,0,0,0,0,0,0,0,0,0,0,0,0,0,0,0,0,0,0,0,0,0,0,0,0,0,0,0,0,0,0,0,0,0,0,0,0,0,0,0,0,0,0,0,0,0,0,0,0,0,0,0,0,0,0,0,0,0,0,0,0,0,0,0,0,0,0,0,0 ],
        [0,0,0,0,0,0,0,0,0,0,0,0,0,0,0,0,0,0,0,0,0,0,0,0,0,0,0,0,0,0,0,0,0,0,0,0,0,0,0,0,0,0,0,0,0,0,0,0,0,0,0,0,0,0,0,0,0,0,0,0,0,0,0,0,0,0,0,0,0,0,0,0,0,0,0,0,0,0,0,0,0,0,0,0,0,0,0,0,0,0,0,0,0,0,0,0,0,0,0,0,0,0,0,0,0,0,0,0,0,0,0,0,0,0,0,0,0,0,0,0 ],
        [0,0,0,0,0,0,0,0,0,0,0,0,0,0,0,0,0,0,0,0,0,0,0,0,0,0,0,0,0,0,0,0,0,0,0,0,0,0,0,0,0,0,0,0,0,0,0,0,0,0,0,0,0,2,2,0,0,0,0,0,0,0,0,0,0,0,0,0,0,0,0,0,0,0,0,0,0,0,0,0,0,0,0,0,0,0,0,0,0,0,0,0,0,0,0,0,0,0,0,0,0,0,0,0,0,0,0,0,0,0,0,0,0,0,0,0,0,0,0,0 ],
        [0,0,0,0,0,0,0,0,0,0,0,0,0,0,0,0,0,0,0,0,0,0,0,0,0,0,0,0,0,0,0,0,0,0,0,0,0,0,0,0,0,0,0,0,0,0,0,0,0,0,0,0,0,0,0,0,0,0,0,0,0,0,0,0,0,0,0,0,0,0,0,0,0,0,0,0,0,0,0,0,0,0,0,0,0,0,0,0,0,0,0,0,0,0,0,0,0,0,0,0,0,0,0,0,0,0,0,0,0,0,0,0,0,0,0,0,0,0,0,0 ],
        [0,0,0,0,0,0,0,0,0,0,0,0,0,0,0,0,0,0,0,0,0,0,0,0,0,0,0,0,0,0,0,0,0,0,0,0,0,0,0,0,0,0,0,0,0,0,0,0,0,0,0,0,0,0,0,0,0,0,0,0,0,0,0,0,0,0,0,0,0,0,0,0,0,0,0,0,0,0,0,0,0,0,0,0,0,0,0,0,0,0,0,0,0,0,0,0,0,0,0,0,0,0,0,0,0,0,0,0,0,0,0,0,0,0,0,0,0,0,0,0 ],
        [0,0,0,0,0,0,0,0,0,0,0,0,0,0,0,0,0,0,0,0,0,0,0,0,0,0,0,0,0,2,0,0,0,0,0,0,0,0,0,0,0,0,0,0,0,0,0,0,0,0,0,0,0,0,0,0,0,0,0,0,0,0,0,0,63,0,0,0,0,0,0,0,0,0,0,0,0,0,0,0,0,0,0,0,0,0,0,0,0,0,0,0,0,0,0,0,0,0,0,0,0,0,0,0,0,0,0,0,0,0,0,0,0,0,0,0,0,0,0,0 ],
        [0,0,0,0,0,0,0,0,0,0,0,0,0,0,0,0,0,0,0,0,0,0,0,0,0,0,0,0,0,0,0,0,0,0,0,0,0,0,0,0,0,0,0,0,0,0,0,0,0,0,0,0,0,0,0,0,0,0,0,0,0,0,0,0,62,0,0,0,0,0,0,0,0,0,0,0,10,11,0,0,0,0,52,52,52,52,52,52,52,52,52,52,52,52,52,52,0,0,0,0,0,0,0,0,0,0,0,0,0,0,0,0,0,0,0,0,0,0,0,0 ],
        [0,0,0,0,0,0,0,0,0,0,0,0,0,0,0,0,0,0,0,0,0,0,0,0,0,0,0,0,0,0,0,0,2,0,0,0,0,0,0,0,0,0,0,0,0,0,0,0,0,0,0,0,0,0,0,0,0,0,0,0,0,0,0,0,0,0,0,0,0,0,0,0,0,0,0,0,0,0,0,0,0,0,9,9,9,9,9,9,9,9,9,9,9,9,0,0,0,0,0,0,0,0,0,0,0,0,0,0,0,0,0,0,0,0,0,0,0,0,0,0 ],
        [0,0,0,0,0,0,0,0,0,0,0,0,0,0,0,0,0,0,0,0,0,0,0,0,0,0,0,0,0,0,0,0,0,0,0,0,0,0,0,0,0,0,0,0,0,0,0,0,0,0,0,0,0,0,0,0,0,0,0,0,0,0,0,0,0,0,0,0,0,0,0,0,0,0,0,0,0,0,0,0,0,0,0,0,0,0,9,9,9,9,9,9,0,0,0,0,0,0,0,0,0,0,0,0,0,0,0,0,0,0,0,0,0,0,0,0,0,0,0,0 ],
        [0,0,2,2,0,0,0,0,0,0,0,0,0,10,11,0,0,0,0,0,0,0,0,0,0,0,0,0,0,0,0,0,0,0,0,0,0,0,0,0,0,0,0,0,0,0,0,52,52,52,0,0,0,0,0,0,0,0,0,0,0,0,0,0,0,0,0,0,0,0,0,0,0,0,0,0,0,0,0,0,0,0,0,0,0,0,0,0,0,0,0,0,0,0,0,0,0,0,0,0,0,0,0,0,0,0,0,0,0,0,0,0,0,0,0,0,0,0,0,0 ],
        [0,0,0,0,0,0,0,0,0,0,0,0,0,0,0,0,0,0,0,0,0,0,0,0,0,0,0,0,0,0,0,0,0,0,0,0,0,0,0,0,0,0,0,0,0,0,0,9,9,9,0,0,0,0,0,0,0,0,0,0,0,0,0,0,0,0,0,0,0,0,0,0,0,0,0,0,0,0,0,0,0,0,0,0,0,0,0,0,0,0,0,0,0,0,0,0,0,0,0,0,0,0,0,0,0,0,0,0,0,0,0,0,0,0,0,0,0,0,0,0 ],
        [0,0,0,0,0,0,0,0,0,0,0,0,0,0,0,0,0,0,0,0,0,0,0,0,0,0,0,0,0,0,0,0,0,0,0,0,0,0,0,0,0,0,0,0,0,0,0,9,9,9,0,0,0,0,0,0,0,0,0,0,0,0,0,0,0,0,0,0,0,0,0,0,0,0,0,0,0,0,0,0,0,0,0,0,0,0,0,0,0,0,0,0,0,0,0,0,0,0,0,0,0,0,0,0,0,0,0,0,0,0,0,0,0,0,0,0,0,0,0,0 ],
        [0,0,0,0,0,0,0,0,0,0,0,0,0,0,0,0,0,0,0,0,0,0,0,0,0,0,0,0,0,0,0,0,0,0,0,0,0,0,0,0,0,0,0,0,0,0,0,9,9,9,0,0,0,0,0,0,0,0,0,0,0,0,0,0,0,0,0,0,0,0,0,0,0,0,0,0,0,0,0,0,0,0,0,0,0,0,0,0,0,0,0,0,0,0,0,0,0,0,0,0,0,0,0,0,0,0,0,0,0,0,0,0,0,0,0,0,0,0,0,0 ],
        [0,0,0,0,0,0,0,0,0,0,0,0,0,0,0,0,0,0,0,0,0,0,0,0,0,0,0,0,0,0,0,0,0,0,0,0,0,0,0,0,0,0,0,0,0,0,0,9,9,9,0,0,0,0,0,0,0,0,0,0,0,0,0,0,0,0,0,0,0,0,0,0,0,0,0,0,0,0,0,0,0,0,0,0,0,0,0,0,0,0,0,0,0,0,0,0,0,0,0,0,0,0,0,0,0,0,0,0,0,0,0,0,0,0,0,0,0,0,0,0 ],
        [0,0,0,0,0,0,0,0,0,0,0,0,0,0,0,0,0,0,0,0,0,0,0,0,0,0,0,0,0,0,0,0,0,0,0,0,0,0,0,0,0,0,0,0,0,0,0,9,9,9,0,0,0,0,0,0,0,0,0,0,0,0,0,0,0,0,0,0,0,0,0,0,0,0,0,0,0,0,0,0,0,0,0,0,0,0,0,0,0,0,0,0,0,0,0,0,0,0,0,0,0,0,0,0,0,0,0,0,0,0,0,0,0,0,0,0,0,0,0,0 ],
        [0,0,0,0,0,0,0,0,0,0,0,0,0,0,0,0,0,0,0,0,0,0,0,0,0,0,0,0,0,0,0,0,0,0,0,0,0,0,0,0,0,0,0,0,0,0,0,9,9,9,0,0,0,0,0,0,0,0,0,0,0,0,0,0,0,0,0,0,0,0,0,0,0,0,0,0,0,0,0,0,0,0,0,0,0,0,0,0,0,0,0,0,0,0,0,0,0,0,0,0,0,0,0,0,0,0,0,0,0,0,0,0,0,0,0,0,0,0,0,0 ],
        [0,0,0,0,0,0,0,0,0,0,0,0,0,0,0,0,0,0,0,0,0,0,0,0,0,0,0,0,0,0,0,0,0,0,0,0,0,0,0,0,0,0,0,0,0,0,0,9,9,9,0,0,0,0,0,0,0,0,0,0,0,0,0,0,0,0,0,0,0,0,0,0,0,0,0,0,0,0,0,0,0,0,0,0,0,0,0,0,0,0,0,0,0,0,0,0,0,0,0,0,0,0,0,0,0,0,0,0,0,0,0,0,0,0,0,0,0,0,0,0 ]
    ],
    "objects":[
        [0,0,0,0,0,0,0,0,0,0,0,0,0,0,0,0,0,0,0,0,0,0,0,0,0,0,0,0,0,0,0,0,0,0,0,0,0,0,0,0,0,0,0,0,0,0,0,0,0,0,0,0,0,0,0,0,0,0,0,0,0,0,0,0,0,0,0,0,0,0,0,0,0,0,0,0,0,0,0,0,0,0,0,0,0,0,0,0,0,0,0,0,0,0,0,0,0,0,0,0,0,0,0,0,0,0,0,0,0,0,0,0,0,0,0,0,0,0,0,0 ],
        [0,0,0,0,0,0,0,0,0,0,0,0,0,0,0,0,0,0,0,0,0,0,0,0,0,0,0,0,0,0,0,0,0,0,0,0,0,0,0,0,0,0,0,0,0,0,0,0,0,0,0,0,0,0,0,0,0,0,0,0,0,0,0,0,0,0,0,0,0,0,0,0,0,0,0,0,0,0,0,0,0,0,0,0,0,0,0,0,0,0,0,0,0,0,0,0,0,0,0,0,0,0,0,0,0,0,0,0,0,0,0,0,0,0,0,0,0,0,0,0 ],
        [0,0,0,0,0,0,0,0,0,0,0,0,0,0,0,0,0,0,0,0,0,0,0,0,0,0,0,0,0,0,0,0,0,0,0,0,0,0,0,0,0,0,0,0,0,0,0,0,0,0,0,0,0,0,0,0,0,0,0,0,0,0,0,0,0,0,0,0,0,0,0,0,0,0,0,0,0,0,0,0,0,0,0,0,0,0,0,0,0,0,0,0,0,0,0,0,0,0,0,0,0,0,0,0,0,0,0,0,0,0,0,0,0,0,0,0,0,0,0,0 ],
        [0,0,0,0,0,0,0,0,0,0,0,0,0,0,0,0,0,0,0,0,0,0,0,0,0,0,0,0,0,0,0,0,0,0,0,0,0,0,0,0,0,0,0,0,0,0,0,0,0,0,0,0,0,0,0,0,0,0,0,0,0,0,0,0,0,0,0,0,0,0,0,0,0,0,0,0,0,0,0,0,0,0,0,0,0,0,0,0,0,0,0,0,0,0,0,0,0,0,0,0,0,0,0,0,0,0,0,0,0,0,0,0,0,0,0,0,0,0,0,0 ],
        [0,0,0,0,0,0,0,0,0,0,0,0,0,0,0,0,0,0,0,0,0,0,0,0,0,0,0,0,0,0,0,0,0,0,0,0,0,0,0,0,0,0,0,0,0,10,0,0,0,0,0,0,0,0,0,0,0,0,0,0,0,0,0,0,0,0,0,0,0,0,0,0,0,0,0,0,0,0,0,0,0,0,0,0,0,0,0,0,0,0,0,0,0,0,0,0,0,0,0,0,0,0,0,0,0,0,0,0,0,0,0,0,0,0,0,0,0,0,0,0 ],
        [0,0,0,0,0,0,0,0,0,0,0,0,0,0,0,0,0,0,0,0,0,0,0,0,0,0,0,0,0,0,0,0,0,0,0,0,0,4,0,0,0,0,0,0,0,0,0,0,0,0,0,0,0,0,0,0,0,0,0,0,0,0,0,0,0,0,0,0,0,0,0,0,0,0,0,0,0,0,0,0,0,0,0,0,0,0,0,0,0,0,0,0,0,0,0,0,0,0,0,0,0,0,0,0,0,0,0,0,0,0,0,0,0,0,0,0,0,0,0,0 ],
        [0,0,0,0,0,0,0,0,0,0,0,0,0,0,0,0,0,0,0,0,0,0,0,0,0,0,0,0,0,0,0,0,0,0,0,0,0,0,0,0,0,0,0,0,0,0,0,0,0,0,0,0,0,0,0,0,0,0,0,0,0,0,0,0,0,0,0,0,0,0,0,0,0,0,0,0,0,0,0,0,0,0,0,0,0,0,0,0,0,0,0,0,0,0,0,0,0,0,0,0,0,0,0,0,0,0,0,0,0,0,0,0,0,0,0,0,0,0,0,0 ],
        [0,0,0,0,0,0,0,0,0,0,0,0,0,0,0,0,0,0,0,0,0,0,0,0,0,0,0,0,0,0,0,0,0,0,0,0,0,0,2,0,0,0,0,0,0,0,2,0,0,0,0,0,0,0,0,0,0,0,0,0,0,0,0,0,0,0,0,0,0,0,0,0,0,0,0,0,0,0,0,0,0,0,0,0,0,0,0,0,0,0,0,0,0,0,0,0,0,0,0,0,0,0,0,0,0,0,0,0,0,0,0,0,0,0,0,0,0,10,0,0 ],
        [0,0,0,0,0,0,0,0,0,0,0,0,0,0,0,0,0,0,0,0,0,0,0,0,0,0,0,0,1,0,3,0,0,0,0,0,0,0,0,0,0,0,0,0,0,0,0,0,0,0,0,0,0,0,0,0,0,0,0,0,0,0,0,0,0,0,0,0,0,0,0,0,0,0,0,0,0,0,0,0,4,0,0,0,0,0,0,0,0,0,0,0,0,0,0,0,0,0,0,0,0,0,0,0,0,0,0,0,0,0,0,0,0,0,0,0,0,0,0,0 ],
        [0,0,0,0,0,0,0,0,0,0,0,0,0,0,0,0,0,0,0,0,0,0,0,0,0,0,0,0,0,0,0,0,0,0,0,0,0,0,0,0,0,0,0,0,0,0,0,0,0,0,0,0,0,0,0,0,0,0,0,10,0,0,4,0,0,0,0,0,0,0,0,0,0,0,0,0,0,1,0,0,0,0,0,0,0,0,0,0,0,0,0,0,0,0,0,0,0,0,0,0,0,0,0,0,0,0,0,0,0,0,0,0,0,0,0,0,0,0,0,0 ],
        [0,0,0,0,0,0,0,0,1,0,0,0,0,0,0,0,0,0,0,0,0,1,0,0,0,0,0,0,0,0,0,0,0,0,0,0,10,0,0,0,0,0,1,0,0,0,0,0,0,0,0,0,0,0,0,0,0,0,0,0,0,0,0,0,0,0,0,0,0,0,0,0,0,0,0,0,0,0,0,0,0,0,0,0,0,0,0,0,0,0,0,0,0,0,0,0,0,0,0,0,0,0,0,0,0,0,3,0,1,0,0,0,0,0,0,0,0,0,0,0 ],
        [0,0,0,0,0,0,0,0,0,0,0,0,0,0,0,0,0,0,0,0,0,0,0,0,0,0,0,0,0,0,0,0,0,0,0,0,0,0,0,0,0,0,0,0,0,0,0,0,0,0,0,0,0,0,0,0,0,0,0,0,0,0,0,0,0,0,0,0,0,0,0,0,0,0,0,0,0,0,0,0,0,0,0,0,0,0,0,0,0,10,0,0,0,0,0,0,0,0,0,0,0,0,0,0,0,0,0,0,0,0,0,0,0,0,0,0,0,0,0,0 ],
        [0,0,0,0,0,0,0,0,0,0,0,0,3,0,10,0,0,0,0,0,0,0,0,0,0,0,0,0,0,0,0,0,0,0,0,0,0,0,0,0,0,0,0,0,0,0,0,0,0,0,0,0,0,0,0,0,0,0,0,0,0,0,0,0,0,0,0,0,0,0,0,0,0,0,0,0,0,0,0,0,0,0,0,0,0,0,0,0,0,0,0,0,0,0,0,0,0,0,0,0,0,0,0,0,0,0,0,0,0,0,0,0,0,0,0,0,0,0,0,0 ],
        [0,0,0,0,0,0,0,0,0,0,0,0,0,0,0,0,0,0,0,0,0,0,0,0,0,0,0,0,0,0,0,0,0,0,0,0,0,0,0,0,0,0,0,0,0,0,0,0,0,0,0,0,0,0,0,0,0,0,0,0,0,0,0,0,0,0,0,0,0,0,0,0,0,0,0,0,0,0,0,0,0,0,0,0,0,0,0,0,0,0,0,0,0,0,0,0,0,0,0,0,0,0,0,0,0,0,0,0,0,0,0,0,1,0,0,0,0,0,0,0 ],
        [0,0,0,0,0,0,0,0,0,0,0,0,0,0,0,0,0,0,0,0,0,0,0,0,0,0,0,0,0,0,0,0,0,0,0,0,0,0,0,0,0,0,0,0,0,0,0,0,0,0,0,0,0,0,0,0,0,0,0,0,0,0,0,0,0,0,0,0,0,0,0,0,0,0,0,0,0,0,0,0,0,0,0,0,0,0,0,0,0,0,0,0,0,0,0,0,0,0,0,0,0,0,0,0,0,0,0,0,0,0,0,0,0,0,0,0,0,0,0,0 ],
        [0,0,0,0,0,0,0,0,0,0,0,0,0,0,0,0,0,0,0,0,0,0,0,0,0,0,0,0,0,0,0,0,0,0,0,0,0,0,0,0,0,0,0,0,0,0,0,0,0,0,0,0,0,0,0,0,0,0,0,0,0,0,0,0,0,0,0,0,0,0,0,0,0,0,0,0,0,0,0,0,0,0,0,0,0,0,0,0,0,0,0,0,0,0,0,0,0,0,0,0,0,0,0,0,0,0,0,0,0,0,0,0,0,0,0,0,0,0,0,0 ],
        [0,0,0,0,0,0,0,0,0,0,0,0,0,0,0,0,0,0,0,0,0,0,0,0,0,0,0,0,0,0,0,0,0,0,0,0,0,0,0,0,0,0,0,0,0,0,0,0,0,0,0,0,0,0,0,0,0,0,0,0,0,0,0,0,0,0,0,0,0,0,0,0,0,0,0,0,0,0,0,0,0,0,0,0,0,0,0,0,0,0,0,0,0,0,0,0,0,0,0,0,0,0,0,0,0,0,0,0,0,0,0,0,0,0,0,0,0,0,0,0 ],
        [0,0,0,0,0,0,0,0,0,0,0,0,0,0,0,0,0,0,0,0,0,0,0,0,0,0,0,0,0,0,0,0,0,0,0,0,0,0,0,0,0,0,0,0,0,0,0,0,0,0,0,0,0,0,0,0,0,0,0,0,0,0,0,0,0,0,0,0,0,0,0,0,0,0,0,0,0,0,0,0,0,0,0,0,0,0,0,0,0,0,0,0,0,0,0,0,0,0,0,0,0,0,0,0,0,0,0,0,0,0,0,0,0,0,0,0,0,0,0,0 ],
        [0,0,0,0,0,0,0,0,0,0,0,0,0,0,0,0,0,0,0,0,0,0,0,0,0,0,0,0,0,0,0,0,0,0,0,0,0,0,0,0,0,0,0,0,0,0,0,0,0,0,0,0,0,0,0,0,0,0,0,0,0,0,0,0,0,0,0,0,0,0,0,0,0,0,0,0,0,0,0,0,0,0,0,0,0,0,0,0,0,0,0,0,0,0,0,0,0,0,0,0,0,0,0,0,0,0,0,0,0,0,0,0,0,0,0,0,0,0,0,0 ],
        [0,0,0,0,0,0,0,0,0,0,0,0,0,0,0,0,0,0,0,0,0,0,0,0,0,0,0,0,0,0,0,0,0,0,0,0,0,0,0,0,0,0,0,0,0,0,0,0,0,0,0,0,0,0,0,0,0,0,0,0,0,0,0,0,0,0,0,0,0,0,0,0,0,0,0,0,0,0,0,0,0,0,0,0,0,0,0,0,0,0,0,0,0,0,0,0,0,0,0,0,0,0,0,0,0,0,0,0,0,0,0,0,0,0,0,0,0,0,0,0 ]
    ]
  },
  "stage2":{
    "tName":"tile02.png",
    "layer1":[
      [0,0,0,0,0,0,0,0,0,0,0,0,0,0,0,0,0,0,0,0 ],
      [0,0,0,0,0,0,0,0,0,0,2,2,2,2,2,3,4,3,4,2 ],
      [0,0,0,0,0,0,0,0,0,0,31,31,31,31,31,31,31,31,31,31 ],
      [0,0,0,0,0,0,0,0,0,0,0,60,0,0,0,0,0,0,0,0 ],
      [0,0,0,0,0,0,0,0,0,0,0,60,0,0,0,0,0,0,0,0 ],
      [0,0,0,2,4,2,2,2,2,0,0,60,0,0,0,0,0,0,0,0 ],
      [0,0,0,31,31,31,31,31,31,0,0,60,0,0,0,0,0,0,4,2 ],
      [0,0,0,0,0,0,0,0,60,0,0,61,0,0,0,0,2,3,31,31 ],
      [0,0,0,0,0,0,0,0,60,0,0,0,0,0,4,3,31,31,30,30 ],
      [0,0,0,0,0,0,0,0,60,0,2,2,2,3,31,31,30,30,30,30 ],
      [0,0,0,0,0,0,0,0,60,0,31,31,31,31,30,30,30,30,30,30 ],
      [0,0,0,0,0,0,0,0,61,0,0,0,0,0,0,0,60,0,0,0 ],
      [0,0,0,0,0,0,0,0,0,0,0,0,0,0,0,0,60,0,0,0 ],
      [2,2,2,3,2,2,4,2,4,4,1,0,0,0,0,0,60,0,0,0 ],
      [32,33,32,33,32,33,32,33,32,33,30,0,0,0,0,0,61,0,0,0 ],
      [36,35,36,35,36,35,36,35,36,35,30,1,1,1,1,1,1,1,1,1 ],
      [36,36,36,36,36,36,36,36,36,36,30,30,30,30,30,30,30,30,30,30 ],
      [34,36,34,36,34,36,34,36,34,36,34,37,34,37,34,37,34,37,34,37 ],
      [36,36,36,36,36,36,36,36,36,36,36,37,37,37,37,37,37,37,37,37 ],
      [36,36,36,36,36,36,36,36,36,36,36,36,36,36,36,37,36,36,37,37 ]
    ],
    "layer2":[
      [0,0,0,0,0,0,0,0,0,0,0,0,0,0,0,0,0,0,0,0 ],
      [0,0,0,0,0,0,0,0,0,5,0,0,0,0,0,0,0,0,0,0 ],
      [0,0,0,0,0,0,0,0,0,6,0,0,0,0,0,0,0,0,0,0 ],
      [0,0,0,0,0,0,0,0,0,0,0,0,0,0,0,0,0,0,0,0 ],
      [0,0,0,0,0,0,0,0,0,0,0,0,0,0,0,0,0,0,0,0 ],
      [0,0,5,0,0,0,0,0,0,0,0,0,0,0,0,0,0,0,0,0 ],
      [0,0,6,0,0,0,0,0,0,0,0,0,0,0,0,0,0,5,0,0 ],
      [0,0,0,0,0,0,0,0,0,0,0,0,0,0,0,5,0,6,0,0 ],
      [0,0,0,0,0,0,0,0,0,0,0,0,0,5,0,6,0,0,0,0 ],
      [0,0,0,0,0,0,0,0,0,5,0,0,0,6,0,0,0,0,0,0 ],
      [0,0,0,0,0,0,0,0,0,6,0,0,0,0,0,0,0,0,0,0 ],
      [0,0,0,0,0,0,0,0,0,0,21,21,21,21,21,21,21,21,21,21 ],
      [0,0,0,0,0,0,0,0,0,0,20,20,20,20,20,20,20,20,20,20 ],
      [0,0,0,0,0,0,0,0,0,0,20,20,20,20,20,20,20,20,20,20 ],
      [0,0,0,0,0,0,0,0,0,0,0,20,20,20,20,20,20,20,20,20 ],
      [0,0,0,0,0,0,0,0,0,0,0,20,20,20,20,20,20,20,20,20 ],
      [0,0,0,0,0,0,0,0,0,0,0,0,0,0,0,0,0,0,0,0 ],
      [0,0,0,0,0,0,0,0,0,0,0,0,0,0,0,0,0,0,0,0 ],
      [0,0,0,0,0,0,0,0,0,0,0,0,0,0,0,0,0,0,0,0 ],
      [0,0,0,0,0,0,0,0,0,0,0,0,0,0,0,0,0,0,0,0 ]
    ]
  }
}